44,44,13,13,44,44,44,44,44,44,44,44,44,44,44,44,44,44,69,44,44,44,44,44,44,44,44,69,44,44,44,44,44,44,44,44,44,44,44,44,44,44,44,44,44,44,44,44,44,44,44,44,44,44,44,44,44,44,44,44,44,44,44,44,44,44,44,44,44,44,44,44,44,44,44,44,44,44,44,44
44,44,13,13,44,44,44,44,44,44,44,44,44,44,44,44,44,44,69,44,44,44,44,44,44,44,44,69,44,44,44,44,44,44,44,44,44,44,44,44,44,44,44,44,44,44,44,44,44,44,44,44,44,44,44,44,44,44,44,44,44,44,44,44,44,44,44,44,44,44,44,44,44,44,44,44,44,44,44,44
44,44,13,13,44,44,44,44,44,44,44,44,44,44,44,44,44,44,77,62,62,62,62,62,62,62,62,79,44,44,44,44,44,44,44,44,44,44,44,44,44,44,44,44,44,44,44,44,44,44,44,44,44,44,44,44,44,44,44,44,44,44,44,44,44,44,44,44,44,44,44,44,44,44,44,44,44,44,44,44
44,44,13,13,44,44,44,44,44,44,44,44,44,44,44,44,44,44,44,44,44,44,44,44,44,44,44,44,44,44,44,44,44,44,44,44,44,44,44,44,44,44,44,44,44,44,44,44,44,44,44,44,44,44,44,44,44,44,44,44,44,44,44,44,44,44,44,44,44,44,44,44,44,44,44,44,44,44,44,44
44,44,13,13,44,44,44,44,44,44,44,44,44,44,44,44,44,44,44,44,44,44,44,44,44,44,44,44,44,44,44,44,44,44,44,44,44,44,44,44,44,44,44,44,44,44,44,44,44,44,44,44,44,44,44,44,44,44,44,44,44,44,44,44,44,44,44,44,44,44,44,44,44,44,44,44,44,44,44,44
44,44,13,13,44,44,44,44,44,44,44,44,44,44,44,44,44,44,44,44,44,44,44,44,44,44,44,44,44,44,44,44,44,44,44,44,44,44,44,44,44,44,44,44,44,44,44,44,44,44,44,44,44,44,44,44,44,44,44,44,44,44,44,44,44,44,44,44,44,44,44,44,44,44,44,44,44,44,44,44
44,44,13,13,44,44,44,44,44,44,44,44,44,44,44,44,44,44,44,44,44,44,44,44,44,44,44,44,44,44,44,44,44,44,44,44,44,44,44,44,44,44,44,44,44,44,44,44,44,44,44,44,44,44,44,44,44,44,44,44,44,44,44,44,44,44,44,44,44,44,44,44,44,44,44,44,44,44,44,44
44,44,13,13,44,44,44,44,44,44,44,44,44,44,44,44,44,44,44,44,44,44,44,44,44,44,44,44,44,44,44,44,44,44,44,44,44,44,44,44,44,44,44,44,44,44,44,61,62,62,63,44,44,44,44,44,44,44,44,44,44,44,44,44,44,44,44,44,44,44,44,44,44,44,44,44,44,44,44,44
44,44,13,13,44,44,44,44,44,44,61,62,62,63,44,44,44,44,44,44,44,44,44,44,44,44,44,44,44,44,44,44,44,44,44,44,44,44,44,44,44,44,44,44,44,44,44,69,44,44,69,44,44,44,44,44,44,44,44,44,44,44,44,44,44,44,44,44,44,44,44,44,44,44,44,44,44,44,44,44
44,44,13,13,44,44,44,44,44,44,69,44,44,69,44,44,44,44,44,44,44,44,44,44,44,44,44,44,44,44,44,44,44,44,44,44,44,44,44,44,44,44,44,44,44,44,44,69,44,44,69,44,44,44,44,44,44,44,44,44,44,44,44,44,44,44,44,44,44,44,44,44,44,44,44,44,44,44,44,44
44,44,13,13,44,44,44,44,44,44,69,44,44,69,44,44,44,44,44,44,44,44,44,44,44,44,44,44,44,44,44,44,44,44,44,44,44,44,44,44,44,44,44,44,61,62,62,79,44,44,69,44,44,44,44,44,44,44,44,44,44,44,44,44,44,44,44,44,44,44,44,44,44,44,44,44,44,44,44,44
44,44,44,44,44,44,44,44,44,44,69,44,44,69,44,44,44,44,44,44,44,44,44,44,44,44,44,44,44,44,44,44,44,44,44,44,44,44,44,44,44,44,44,44,69,44,44,44,44,44,69,44,44,44,44,44,44,44,44,44,44,44,44,44,44,44,44,44,44,44,44,44,44,44,44,44,44,44,44,44
44,44,44,44,44,44,44,44,44,44,69,44,44,69,44,44,44,44,44,44,44,44,44,44,44,44,44,44,44,44,44,44,44,44,44,44,44,44,44,44,44,44,44,44,69,44,44,44,44,44,69,44,44,44,44,44,44,44,44,44,44,44,44,44,44,44,44,44,44,44,44,44,44,44,44,44,44,44,33,44
44,44,44,44,44,44,44,44,44,44,69,44,44,69,44,44,44,44,44,44,44,44,44,44,44,44,44,44,44,44,44,44,44,44,44,44,44,44,44,44,44,44,44,44,69,44,44,44,44,44,69,44,44,44,44,44,44,44,44,44,44,44,44,44,44,44,44,44,44,44,44,44,44,44,44,44,44,44,44,44
44,44,44,44,44,44,44,44,44,44,69,44,44,69,44,44,44,44,44,44,44,44,44,44,44,44,44,44,44,44,44,44,44,44,44,44,44,44,44,44,44,44,44,44,77,62,62,62,63,44,69,44,44,44,44,44,44,44,44,44,44,44,44,44,44,44,44,44,44,35,35,35,35,35,35,35,35,35,35,35
44,44,44,44,44,44,44,44,44,44,69,44,44,69,44,44,44,44,44,112,44,44,44,44,44,44,112,44,44,44,44,44,112,44,44,44,44,44,44,44,44,44,44,44,44,44,44,44,69,44,69,44,44,44,44,44,44,44,44,44,44,44,44,44,44,44,44,35,35,35,35,35,35,35,35,35,35,35,35,35
44,44,44,44,44,44,44,44,44,44,69,44,44,69,112,36,35,35,35,35,35,35,35,35,35,35,35,35,36,35,35,35,35,35,35,35,35,35,112,44,44,44,44,44,44,44,44,44,69,44,69,44,44,44,44,44,44,44,44,44,44,44,44,44,44,35,35,35,35,35,35,35,35,35,35,35,35,35,35,35
44,44,44,44,44,44,44,44,44,44,69,112,44,69,35,36,35,35,35,35,35,35,35,35,36,35,35,35,35,35,35,35,36,35,35,35,35,35,35,35,35,36,35,36,35,44,44,35,69,44,69,44,44,44,44,44,44,44,44,44,44,35,35,35,35,35,35,35,35,35,35,35,35,35,35,35,35,35,35,35
35,35,35,35,35,35,35,35,44,44,35,35,35,35,35,35,35,44,44,44,44,44,44,44,44,44,44,44,44,44,44,44,44,44,35,35,35,35,44,44,44,44,44,44,44,44,44,35,35,35,35,35,35,35,35,35,35,35,35,35,35,35,35,35,35,35,35,35,35,35,35,35,35,35,35,35,35,35,35,35
35,35,35,35,35,35,35,35,35,44,44,44,44,44,44,44,44,44,44,44,44,44,44,44,44,44,44,44,44,44,44,44,44,44,44,44,44,44,44,44,44,44,44,35,35,35,91,35,35,35,35,35,35,35,35,35,35,35,35,35,35,35,35,35,35,35,35,35,35,35,35,35,35,35,35,35,35,35,35,35
35,35,35,92,35,35,35,35,35,44,44,44,44,44,44,44,44,44,44,44,44,44,44,44,44,44,44,44,44,44,44,44,44,44,44,44,44,44,44,44,35,35,35,35,35,35,35,35,35,35,35,35,35,35,35,35,35,35,35,35,35,35,35,35,35,35,35,35,35,35,35,35,35,35,35,35,35,35,35,35
35,35,35,35,35,35,35,35,35,35,35,35,35,112,35,35,35,35,35,35,35,35,35,35,35,35,35,35,35,35,35,35,35,35,35,35,112,35,35,35,35,35,35,35,35,35,35,35,35,35,35,35,35,35,35,35,35,35,35,35,35,35,35,35,35,35,35,35,35,35,35,35,35,35,35,35,35,35,35,35
35,35,35,35,35,35,35,35,36,35,35,35,35,35,35,35,35,35,35,36,35,91,35,35,35,35,35,35,35,35,35,35,35,35,35,35,35,35,35,35,92,35,35,35,35,35,35,35,35,35,35,35,91,35,35,35,35,35,35,35,35,35,35,35,35,35,35,35,35,35,35,35,35,35,35,35,35,35,35,35
